TopN=TopN
ToothCloseM=TopN/ToothCloseM
ToothOpenM=TopN/ToothOpenM
EyeYellowM=TopN/EyeYellowM
TransN=TopN/TransN
XRotN=TopN/TransN/XRotN
YRotN=TopN/TransN/XRotN/YRotN
HipN=TopN/TransN/XRotN/YRotN/HipN
HolsterN=TopN/TransN/XRotN/YRotN/HipN/HolsterN
LLegJ=TopN/TransN/XRotN/YRotN/HipN/LLegJ
LKneeJ=TopN/TransN/XRotN/YRotN/HipN/LLegJ/LKneeJ
LFootJ=TopN/TransN/XRotN/YRotN/HipN/LLegJ/LKneeJ/LFootJ
LToeN=TopN/TransN/XRotN/YRotN/HipN/LLegJ/LKneeJ/LFootJ/LToeN
RLegJ=TopN/TransN/XRotN/YRotN/HipN/RLegJ
RKneeJ=TopN/TransN/XRotN/YRotN/HipN/RLegJ/RKneeJ
RFootJ=TopN/TransN/XRotN/YRotN/HipN/RLegJ/RKneeJ/RFootJ
RToeN=TopN/TransN/XRotN/YRotN/HipN/RLegJ/RKneeJ/RFootJ/RToeN
WaistN=TopN/TransN/XRotN/YRotN/HipN/WaistN
BustN=TopN/TransN/XRotN/YRotN/HipN/WaistN/BustN
CollarN=TopN/TransN/XRotN/YRotN/HipN/WaistN/BustN/CollarN
LShoulderN=TopN/TransN/XRotN/YRotN/HipN/WaistN/BustN/LShoulderN
LShoulderJ=TopN/TransN/XRotN/YRotN/HipN/WaistN/BustN/LShoulderN/LShoulderJ
LArmJ=TopN/TransN/XRotN/YRotN/HipN/WaistN/BustN/LShoulderN/LShoulderJ/LArmJ
LHandN=TopN/TransN/XRotN/YRotN/HipN/WaistN/BustN/LShoulderN/LShoulderJ/LArmJ/LHandN
L1stNa=TopN/TransN/XRotN/YRotN/HipN/WaistN/BustN/LShoulderN/LShoulderJ/LArmJ/LHandN/L1stNa
L1stNb=TopN/TransN/XRotN/YRotN/HipN/WaistN/BustN/LShoulderN/LShoulderJ/LArmJ/LHandN/L1stNa/L1stNb
L2ndNa=TopN/TransN/XRotN/YRotN/HipN/WaistN/BustN/LShoulderN/LShoulderJ/LArmJ/LHandN/L2ndNa
L2ndNb=TopN/TransN/XRotN/YRotN/HipN/WaistN/BustN/LShoulderN/LShoulderJ/LArmJ/LHandN/L2ndNa/L2ndNb
L3rdNa=TopN/TransN/XRotN/YRotN/HipN/WaistN/BustN/LShoulderN/LShoulderJ/LArmJ/LHandN/L3rdNa
L3rdNb=TopN/TransN/XRotN/YRotN/HipN/WaistN/BustN/LShoulderN/LShoulderJ/LArmJ/LHandN/L3rdNa/L3rdNb
L4thNa=TopN/TransN/XRotN/YRotN/HipN/WaistN/BustN/LShoulderN/LShoulderJ/LArmJ/LHandN/L4thNa
L4thNb=TopN/TransN/XRotN/YRotN/HipN/WaistN/BustN/LShoulderN/LShoulderJ/LArmJ/LHandN/L4thNa/L4thNb
LHandBN=TopN/TransN/XRotN/YRotN/HipN/WaistN/BustN/LShoulderN/LShoulderJ/LArmJ/LHandN/LHandBN
LHaveN=TopN/TransN/XRotN/YRotN/HipN/WaistN/BustN/LShoulderN/LShoulderJ/LArmJ/LHandN/LHaveN
LThumbNa=TopN/TransN/XRotN/YRotN/HipN/WaistN/BustN/LShoulderN/LShoulderJ/LArmJ/LHandN/LThumbNa
LThumbNb=TopN/TransN/XRotN/YRotN/HipN/WaistN/BustN/LShoulderN/LShoulderJ/LArmJ/LHandN/LThumbNa/LThumbNb
LSideN=TopN/TransN/XRotN/YRotN/HipN/WaistN/BustN/LShoulderN/LSideN
NeckN=TopN/TransN/XRotN/YRotN/HipN/WaistN/BustN/NeckN
HeadN=TopN/TransN/XRotN/YRotN/HipN/WaistN/BustN/NeckN/HeadN
MouthBN=TopN/TransN/XRotN/YRotN/HipN/WaistN/BustN/NeckN/HeadN/MouthBN
MouthN=TopN/TransN/XRotN/YRotN/HipN/WaistN/BustN/NeckN/HeadN/MouthN
RShoulderN=TopN/TransN/XRotN/YRotN/HipN/WaistN/BustN/RShoulderN
PadN=TopN/TransN/XRotN/YRotN/HipN/WaistN/BustN/RShoulderN/PadN
PadM=TopN/TransN/XRotN/YRotN/HipN/WaistN/BustN/RShoulderN/PadN/PadM
RShoulderJ=TopN/TransN/XRotN/YRotN/HipN/WaistN/BustN/RShoulderN/RShoulderJ
RArmJ=TopN/TransN/XRotN/YRotN/HipN/WaistN/BustN/RShoulderN/RShoulderJ/RArmJ
RHandN=TopN/TransN/XRotN/YRotN/HipN/WaistN/BustN/RShoulderN/RShoulderJ/RArmJ/RHandN
R1stNa=TopN/TransN/XRotN/YRotN/HipN/WaistN/BustN/RShoulderN/RShoulderJ/RArmJ/RHandN/R1stNa
R1stNb=TopN/TransN/XRotN/YRotN/HipN/WaistN/BustN/RShoulderN/RShoulderJ/RArmJ/RHandN/R1stNa/R1stNb
R2ndNa=TopN/TransN/XRotN/YRotN/HipN/WaistN/BustN/RShoulderN/RShoulderJ/RArmJ/RHandN/R2ndNa
R2ndNb=TopN/TransN/XRotN/YRotN/HipN/WaistN/BustN/RShoulderN/RShoulderJ/RArmJ/RHandN/R2ndNa/R2ndNb
R3rdNa=TopN/TransN/XRotN/YRotN/HipN/WaistN/BustN/RShoulderN/RShoulderJ/RArmJ/RHandN/R3rdNa
R3rdNb=TopN/TransN/XRotN/YRotN/HipN/WaistN/BustN/RShoulderN/RShoulderJ/RArmJ/RHandN/R3rdNa/R3rdNb
R4thNa=TopN/TransN/XRotN/YRotN/HipN/WaistN/BustN/RShoulderN/RShoulderJ/RArmJ/RHandN/R4thNa
R4thNb=TopN/TransN/XRotN/YRotN/HipN/WaistN/BustN/RShoulderN/RShoulderJ/RArmJ/RHandN/R4thNa/R4thNb
RHandBN=TopN/TransN/XRotN/YRotN/HipN/WaistN/BustN/RShoulderN/RShoulderJ/RArmJ/RHandN/RHandBN
RHaveN=TopN/TransN/XRotN/YRotN/HipN/WaistN/BustN/RShoulderN/RShoulderJ/RArmJ/RHandN/RHaveN
RThumbNa=TopN/TransN/XRotN/YRotN/HipN/WaistN/BustN/RShoulderN/RShoulderJ/RArmJ/RHandN/RThumbNa
RThumbNb=TopN/TransN/XRotN/YRotN/HipN/WaistN/BustN/RShoulderN/RShoulderJ/RArmJ/RHandN/RThumbNa/RThumbNb
RSideN=TopN/TransN/XRotN/YRotN/HipN/WaistN/BustN/RShoulderN/RSideN
ScarfNbase=TopN/TransN/XRotN/YRotN/HipN/WaistN/BustN/ScarfNbase
ScarfNa=TopN/TransN/XRotN/YRotN/HipN/WaistN/BustN/ScarfNbase/ScarfNa
ScarfNb=TopN/TransN/XRotN/YRotN/HipN/WaistN/BustN/ScarfNbase/ScarfNa/ScarfNb
ScarfNc=TopN/TransN/XRotN/YRotN/HipN/WaistN/BustN/ScarfNbase/ScarfNa/ScarfNb/ScarfNc
ScarfNend=TopN/TransN/XRotN/YRotN/HipN/WaistN/BustN/ScarfNbase/ScarfNa/ScarfNb/ScarfNc/ScarfNend
ThrowN=TopN/TransN/XRotN/YRotN/ThrowN